1111111111111
100000001E111
100C000110111
10P0010000011
10C01C0000011
1111111111111